111111111111111111111111111111111111111111111111111111111111111111111111
11                                                                    11
11                                                                    11
11                                                                    11
11                                                                    11
11                                                                    11
11        5 6                                               5  6      11
11111111111111111111111111                 11111111111111111111111111111
11                                                                    11
11                                                                    11
11                                                                    11
11         5 6                                              5  6      11
111111111111111111111111111                11111111111111111111111111111
11111111111111111111111111                 11111111111111111111111111111
11                                                                    11
11                                                                    11
11                                                                    11
11         5                                               5          11
111111111111111111111111111                11111111111111111111111111111
11111111111111111111111111                 11111111111111111111111111111
11                                                                    11
11                                                                    11
11                                                                    11
11         0                                                9         11
111111111111111111111111111                11111111111111111111111111111
11111111111111111111111111                 11111111111111111111111111111
11                                                                    11
11                                                                    11
11                                                                    11
11        5                                                 5         11
111111111111111111111111111                11111111111111111111111111111
11111111111111111111111111                 11111111111111111111111111111
11                                                                    11
11                                                                    11
11                                                                    11
11       5                                                            11
111111111111111111111111111                11111111111111111111111111111
11111111111111111111111111                 11111111111111111111111111111
11                                                                    11
11                                                                    11
11                                                                    11
11        5                                        8        5         11
111111111111111111111111111                11111111111111111111111111111
11111111111111111111111111                 11111111111111111111111111111
11                                                                    11
11                                                                    11
                                                                        
          5      8      7                                      5           
111111111111111111111111111                11111111111111111111111111111
11111111111111111111111111                 11111111111111111111111111111
11                                                                    11
11                                                                    11
11                                                                    11
11         5        6                                       5  6      11
111111111111111111111111111                11111111111111111111111111111
222222222222222222222222222222222222222222222222222222222222222222222222