111111111111111111111111111111111111111111111111111111111111111111111111
11                                                                    11
11                                                                    11
11                                                                    11
11                                                                    11
11                                                                    11
11                                                                    11
111111111111111111111111111                11111111111111111111111111111
11                                                                    11
11                                                                    11
11                                                                    11
11                                                                    11
111111111111111111111111111                11111111111111111111111111111
111111111111111111111111111                11111111111111111111111111111
11                                                                    11
11                                                                    11
11                                                                    11
11                                                                    11
111111111111111111111111111                11111111111111111111111111111
111111111111111111111111111                11111111111111111111111111111
11                                                                    11
11                                                                    11
11                                                                    11
11                                                                    11
111111111111111111111111111                11111111111111111111111111111
111111111111111111111111111                11111111111111111111111111111
11                                                                    11
11                                                                    11
11                                                                    11
11                                                                    11
111111111111111111111111111                11111111111111111111111111111
111111111111111111111111111                11111111111111111111111111111
11                                                                    11
11                                                                    11
11                                                                    11
11                                                                    11
111111111111111111111111111                11111111111111111111111111111
111111111111111111111111111                11111111111111111111111111111
11                                                                    11
11                                                                    11
11                                                                    11
11                                                                    11
111111111111111111111111111                11111111111111111111111111111
111111111111111111111111111                11111111111111111111111111111
11                                                                    11
11                                                                    11
11                                                                    11
11                                                                    11
111111111111111111111111111                11111111111111111111111111111
111111111111111111111111111                11111111111111111111111111111
11                                                                    11
11                                                                    11
11                                                                    11
11                                                                    11
111111111111111111111111111                11111111111111111111111111111
222222222222222222222222222222222222222222222222222222222222222222222222